111111111111111111111
1000BGGGGRGGGGB000001
100000000G00000000001
100000000G000LUDR0001
100000000G000EFVG0001
100000000G000THNB0001
100000000B00000000001
111111111111111111111

111111111111111111111
1000C000000000C000001
100000000000000000001
100000000000000000001
100000000000000000001
100000000000000000001
100000000P00000000001
111111111111111111111

1 06 01 01 0 0 0
